"filename", "language", "Rust", "comment", "blank", "total"
"/Users/a1111/solana/flarb/src/arbitrage.rs", "Rust", 0, 1, 0, 1
"/Users/a1111/solana/flarb/src/config.rs", "Rust", 222, 31, 42, 295
"/Users/a1111/solana/flarb/src/data.rs", "Rust", 864, 132, 134, 1130
"/Users/a1111/solana/flarb/src/decoder.rs", "Rust", 200, 99, 47, 346
"/Users/a1111/solana/flarb/src/fetch_address.rs", "Rust", 243, 11, 37, 291
"/Users/a1111/solana/flarb/src/graph.rs", "Rust", 0, 1, 1, 2
"/Users/a1111/solana/flarb/src/lib.rs", "Rust", 10, 1, 1, 12
"/Users/a1111/solana/flarb/src/macros.rs", "Rust", 0, 1, 0, 1
"/Users/a1111/solana/flarb/src/main.rs", "Rust", 52, 18, 22, 92
"/Users/a1111/solana/flarb/src/math.rs", "Rust", 0, 1, 0, 1
"/Users/a1111/solana/flarb/src/mempool.rs", "Rust", 0, 1, 0, 1
"/Users/a1111/solana/flarb/src/optimazer.rs", "Rust", 0, 1, 0, 1
"/Users/a1111/solana/flarb/src/params.rs", "Rust", 28, 58, 6, 92
"/Users/a1111/solana/flarb/src/predict.rs", "Rust", 0, 1, 0, 1
"/Users/a1111/solana/flarb/src/quote.rs", "Rust", 33, 2, 8, 43
"/Users/a1111/solana/flarb/src/router.rs", "Rust", 0, 1, 0, 1
"/Users/a1111/solana/flarb/src/ws_data.rs", "Rust", 195, 33, 41, 269
"/Users/a1111/solana/flarb/src/ws_meteora.rs", "Rust", 193, 91, 33, 317
"/Users/a1111/solana/flarb/src/ws_orca.rs", "Rust", 229, 96, 38, 363
"/Users/a1111/solana/flarb/src/ws_parser.rs", "Rust", 154, 37, 15, 206
"/Users/a1111/solana/flarb/src/ws_raydium.rs", "Rust", 220, 91, 36, 347
"Total", "-", 2643, 708, 461, 3812